2 20 10
####################
#       >          #
#       ####       #
#           ###    #
#                ###
#                  #
#########  #########
#wwwwwwwwwwwwwwwwww#
#wwwwwwwww#wwwwwwww#
####################

####################
#       <          #
#   #####          #
#                  #
#################  #
#wwwwwwwwwwwwwwwwww#
#ww#################
#wwwwwwwwwwwwwwwwww#
#wwwwwwwwwwwwwwwwww#
####################
