1 20 10
####################
#                  #
#       ####       #
#           ###    #
#                ###
#                  #
#########  #########
#wwwwwwwwwwwwwwwwww#
#wwwwwwwww#wwwwwwww#
####################
