1 50 20
##################################################
#                                                #
#       #                    ################### #
#        #    #########    ##                  # #
###   #   #                              ###   # #
#      #  # #####  #  ####  ####   ##   #  #     #
#####     #        ##     # #         ##   # ##  #
#        # #      ####      #    #####           #
###   ###     ####    #   ### ###       ###     ##
#         ####     #   ###                 #     #
#  ##  ###        #        #    ###   ###   # #  #
#     ##     #     ####   #        ###       ##  #
##        ###   #        ######           #      #
#              #######  #     #       #      #####
#  # # ##            #     #  #        ####      #
#        ######     ## ####     #   #          # #
####             #          ##  ##    #########  #
#  ####  ###      #             ###  ##          #
#              ### #   #   #####  ###   ##########
##################################################

